W W W W W W W W W W W W W W W W W W W W W W W W W W W W
W S S S S S S S S S S S S W W S S S S S S S S S S S S W
W S W W W W S W W W W W S W W S W W W W W S W W W W S W
W S W W W W S W W W W W S W W S W W W W W S W W W W S W
W B W W W W S W W W W W S W W S W W W W W S W W W W B W
W S S S S S S S S S S S S S S S S S S S S S S S S S S W
W S W W W W S W W S W W W W W W W W S W W S W W W W S W
W S W W W W S W W S W W W W W W W W S W W S W W W W S W
W S S S S S S W W S S S S W W S S S S W W S S S S S S W
W W W W W W S W W W W W E W W E W W W W W S W W W W W W
E E E E E W S W W W W W E W W E W W W W W S W E E E E E
E E E E E W S W W E E E E E E E E E E W W S W E E E E E
E E E E E W S W W E W E E E E E E W E W W S W E E E E E
W W W W W W S W W E W E E E E E E W E W W S W W W W W W
E E E E E E S E E E W E 1 E E 2 E W E E E S E E E E E E
W W W W W W S W W E W E E E E E E W E W W S W W W W W W
E E E E E W S W W E W W W W W W W W E W W S W E E E E E
E E E E E W S W W E E E E E E E E E E W W S W E E E E E
E E E E E W S W W E W W W W W W W W E W W S W E E E E E
W W W W W W S W W E W W W W W W W W E W W S W W W W W W
W S S S S S S S S S S S S W W S S S S S S S S S S S S W
W S W W W W S W W W W W S W W S W W W W W S W W W W S W
W S W W W W S W W W W W S W W S W W W W W S W W W W S W
W B S S W W S S S S S S S P S S S S S S S S W W S S B W
W W W S W W S W W S W W W W W W W W S W W S W W S W W W
W W W S W W S W W S W W W W W W W W S W W S W W S W W W
W S S S S S S W W S S S S W W S S S S W W S S S S S S W
W S W W W W W W W W W W S W W S W W W W W W W W W W S W
W S W W W W W W W W W W S W W S W W W W W W W W W W S W
W S S S S S S S S S S S S S S S S S S S S S S S S S S W
W W W W W W W W W W W W W W W W W W W W W W W W W W W W