W W W W W W W W W W W W W W W W W W W W W W W W W W W W
W P S S S S W S S W W S S S W S S S S S S S S S S S S W
W S S S S S W S S W W S S S W S W W W W W S W W W W S W
W S S S S S S S S W W S S S W S W W W W W S W W W W S W
W S S S S S W S S W W S S S W S W W W W W S W W W W S W
W S S S S S W S S W W S S S S S S S S S S S S S S S S W
W W W W W W W S S W W S S S W W W W W W W W W W W W S W
W S S S S S S S S W W S S S W S S S W W W W W W W W S W
W S S S S S S S S S S S S S W S W S W W W S S S S S S W
W W W W W W W W S S S S S S W S W S W W W S W W W W W W
W W W W W W W W S S S S W W W S W S W W W S W W W W W W
W S S S S S 1 2 S S S S S S S S S S W W W S W S S S S W
S S S S S S S S S S W S W S W S W S W W W S S S S S S S
W S S S S S S S S S W S W W W S W S W W W S W S S S S W
W W W S W W W W W W W S W S W S W S W E E S W W W W W W
W W W S W S S S S S S S S S S S S S W W W S W W W W W W
W W W S W S W W W S W W W 3 W W W S W W W S W S S S S W
S S S S W S W W W S W W W S W W W S W W W S W S S S S S
W W W S W S W W W S W W W S W W W S W W W S W S S S S W
W W W S W S S S S S S S S S S S S S S S S S W W W W W W
W W W S W W W W W W W W W W W W W W W W W S S S S S S W
W S S S S S W W W W W W S W W S W W W W W S W W W W S W
W S W W W S W W W W W W S W W S W W W W W S W W W W S W
W S W W W S S S S S S S S S S S S S S S S S W W S S B W
W S W W W S W W W S W W W W W W W W S W W S W W S W W W
W S S S S S W W W S W W W W W W W W S W W S W W S W W W
W S W W W S W W W S S S S W W S S S S W W S S S S S S W
W S W W W S W W W W W W S W W S W W W W W W W W W W S W
W S W W W S W W W W W W S W W S W W W W W W W W W W S W
W S S S S S S S S S S S S S S S S S S S S S S S S S S W
W W W W W W W W W W W W W W W W W W W W W W W W W W W W